{"matriz":[
  [0,0,0,0,0,0,0,0,0,0,0,1,1,1,1,0,0,0,0,0],
  [0,0,0,0,0,0,0,0,0,0,0,0,1,1,0,0,0,0,0,0],
  [0,0,1,0,0,0,0,1,0,0,0,0,0,1,0,0,1,0,0,0],
  [1,1,1,1,1,1,1,2,1,0,0,0,0,0,0,0,1,0,0,0],
  [0,0,0,0,0,1,0,0,0,1,1,0,0,0,0,0,1,0,0,0],
  [0,0,0,0,0,0,0,0,0,0,0,1,0,0,0,1,2,0,0,0],
  [0,0,0,1,0,0,1,1,0,0,0,0,1,1,1,2,2,0,0,0],
  [0,0,0,0,1,1,1,0,0,0,0,0,0,0,0,0,0,0,0,0],
  [0,0,0,0,1,1,0,0,0,0,0,0,0,0,0,0,0,0,0,0],
  [0,0,0,0,1,1,0,0,0,0,0,0,1,1,1,1,1,0,0,0],
  [0,0,2,1,1,1,0,0,0,1,1,1,2,2,2,2,2,1,1,0],
  [0,0,2,1,1,0,0,0,0,0,0,0,0,0,0,0,0,0,0,1],
  [0,0,1,0,0,0,0,0,0,0,0,0,0,0,0,0,0,0,0,0],
  [0,0,0,0,0,0,0,0,0,0,0,0,0,0,0,0,0,0,0,0],
  [0,0,0,0,0,0,0,0,0,0,0,0,1,1,1,0,1,0,0,0],
  [0,0,0,1,1,1,2,2,2,1,1,1,2,2,2,1,1,0,0,0],
  [0,1,1,2,2,2,1,1,1,0,0,0,0,0,0,0,0,0,0,0],
  [1,0,0,0,0,0,0,0,0,0,0,0,0,0,0,0,0,0,0,0],
  [0,0,0,0,0,0,0,0,0,0,0,0,0,0,0,0,0,0,0,0],
  [0,0,0,0,0,0,0,0,0,0,0,0,0,0,0,0,0,0,0,2]
  ],
  "spectres":[
    {"id":"spectre_01",
    "type":"spectre_gray",
    "position":[19,17],
    "direction": "west",
    "routeVelocity": 3.0,
    "persuitVelocity": 2.0,
    "visionRange": 3,
    "patrolRoute":[[18,17],[17,17],[16,17],[15,17],[14,17],[13,17],[12,17],[11,17],[10,17],[9,17],[8,17],[7,17],[6,17],[5,17],[4,17],[3,17],[4,17],[5,17],[6,17],[7,17],[8,17],[9,17],[10,17],[11,17],[12,17],[13,17],[14,17],[15,17],[16,17],[17,17],[18,17],[19,17],[19,16],[19,15],[19,14],[19,13],[19,12],[19,13],[19,14],[19,15],[19,16],[19,17]]}
  ],
  "objects":[1,2],
  "simpleEnemies":[1,2]
}